+---+---+---+---+---+---+---+---+---+---+---+---+---+---+---+---+---+---+---+---+---+---+---+---+---+---+---+---+---+---+
|                                                                                                                       |
+   +   +---+---+   +   +---+---+   +   +   +   +---+---+   +   +   +   +---+---+---+   +   +---+---+---+   +   +   +   +
|   |   |           |   |           |   |   |   |           |   |   |   |               |   |               |   |   |   |
+   +---+---+   +---+   +---+---+---+---+---+---+   +---+   +   +   +---+---+---+   +---+---+---+   +   +---+---+---+   +
|   |           |       |                           |       |   |   |               |               |   |               |
+---+   +---+   +   +   +   +   +   +---+   +   +---+   +---+   +---+---+   +   +---+   +---+---+---+   +   +   +   +   +
|       |       |   |   |   |   |   |       |   |       |       |           |   |       |               |   |   |   |   |
+   +---+---+---+   +   +   +   +---+---+   +   +---+   +   +---+   +---+   +   +---+---+---+   +---+   +---+   +   +   +
|   |               |   |   |   |           |   |       |   |       |       |   |               |       |       |   |   |
+---+   +   +   +   +   +---+---+---+   +---+---+   +---+---+   +---+---+   +---+   +---+   +---+   +   +   +   +---+   +
|       |   |   |   |   |               |           |           |           |       |       |       |   |   |   |       |
+   +---+   +---+---+---+   +   +---+   +   +   +---+---+   +---+   +---+   +---+---+---+---+---+   +---+---+   +   +   +
|   |       |               |   |       |   |   |           |       |       |                       |           |   |   |
+---+   +---+---+   +   +   +---+---+   +---+   +---+---+   +   +   +   +---+   +---+   +   +---+---+---+---+---+---+   +
|       |           |   |   |           |       |           |   |   |   |       |       |   |                           |
+---+   +   +   +---+---+   +---+---+   +---+   +---+---+---+---+   +---+---+---+---+---+   +   +---+   +   +   +---+   +
|       |   |   |           |           |       |                   |                       |   |       |   |   |       |
+   +---+   +---+---+   +---+---+   +   +   +---+---+---+---+   +   +   +---+---+---+---+---+---+   +   +   +   +---+   +
|   |       |           |           |   |   |                   |   |   |                           |   |   |   |       |
+---+---+   +---+   +   +   +---+---+   +---+   +---+---+   +   +---+   +---+   +   +---+   +   +---+   +   +   +---+   +
|           |       |   |   |           |       |           |   |       |       |   |       |   |       |   |   |       |
+   +---+   +---+   +   +   +   +   +---+   +---+---+---+---+   +   +---+   +   +---+   +   +   +   +---+   +---+---+   +
|   |       |       |   |   |   |   |       |                   |   |       |   |       |   |   |   |       |           |
+   +---+   +---+   +   +   +---+---+---+   +   +   +---+---+   +---+---+---+---+---+   +---+---+   +---+   +---+   +   +
|   |       |       |   |   |               |   |   |           |                       |           |       |       |   |
+---+   +   +   +---+---+   +   +---+   +---+---+---+   +   +---+---+---+---+---+   +   +---+   +---+   +   +---+---+   +
|       |   |   |           |   |       |               |   |                       |   |       |       |   |           |
+---+   +   +---+   +---+   +---+   +---+   +---+---+   +   +---+---+   +---+---+---+   +   +---+   +   +   +   +---+   +
|       |   |       |       |       |       |           |   |           |               |   |       |   |   |   |       |
+   +---+   +---+---+   +---+---+---+   +   +---+   +---+---+   +---+---+---+---+---+   +---+---+   +   +   +---+---+   +
|   |       |           |               |   |       |           |                       |           |   |   |           |
+---+   +---+---+   +   +   +---+---+   +   +---+---+   +   +   +---+---+   +---+   +   +   +---+   +   +---+   +---+   +
|       |           |   |   |           |   |           |   |   |           |       |   |   |       |   |       |       |
+---+   +   +---+   +   +   +   +---+   +---+   +---+---+---+---+---+   +---+   +---+---+   +   +   +   +---+   +   +   +
|       |   |       |   |   |   |       |       |                       |       |           |   |   |   |       |   |   |
+   +---+---+   +   +---+---+---+---+   +---+---+---+---+---+---+   +   +   +   +   +---+   +   +   +---+   +   +   +   +
|   |           |   |                   |                           |   |   |   |   |       |   |   |       |   |   |   |
+---+---+---+   +---+   +   +---+---+---+---+---+   +   +   +---+   +---+   +   +---+---+---+   +   +---+   +   +   +   +
|               |       |   |                       |   |   |       |       |   |               |   |       |   |   |   |
+   +---+---+   +   +   +   +   +   +---+   +   +   +---+---+---+   +---+---+---+   +   +---+   +---+---+   +   +---+   +
|   |           |   |   |   |   |   |       |   |   |               |               |   |       |           |   |       |
+---+   +   +   +---+   +---+   +   +   +   +---+   +---+---+   +   +---+---+---+   +---+   +   +---+   +   +   +---+   +
|       |   |   |       |       |   |   |   |       |           |   |               |       |   |       |   |   |       |
+   +---+---+---+---+---+   +---+   +---+---+   +---+---+   +---+   +---+   +---+   +---+   +   +   +   +---+---+   +   +
|   |                       |       |           |           |       |       |       |       |   |   |   |           |   |
+   +   +---+   +---+   +   +   +   +---+---+---+---+   +---+---+---+---+---+   +---+   +---+   +---+---+---+---+---+   +
|   |   |       |       |   |   |   |                   |                       |       |       |                       |
+---+---+---+---+   +---+---+---+---+---+---+---+   +---+   +---+---+   +   +   +   +---+   +---+---+---+   +---+---+   +
|                   |                               |       |           |   |   |   |       |               |           |
+---+   +---+---+---+   +---+---+   +---+---+---+---+   +---+---+   +   +---+---+---+---+   +   +   +   +   +   +---+   +
|       |               |           |                   |           |   |                   |   |   |   |   |   |       |
+---+   +   +   +   +   +---+   +   +---+---+   +   +---+   +---+---+---+---+   +---+---+---+---+---+   +   +   +   +   +
|       |   |   |   |   |       |   |           |   |       |                   |                       |   |   |   |   |
+   +   +   +---+---+---+   +   +---+   +---+   +   +---+---+---+---+---+---+   +   +---+---+   +   +   +---+---+   +   +
|   |   |   |               |   |       |       |   |                           |   |           |   |   |           |   |
+---+   +---+---+   +   +   +   +---+   +---+---+---+   +   +---+---+---+   +---+---+---+   +---+   +---+   +---+   +   +
|       |           |   |   |   |       |               |   |               |               |       |       |       |   |
+   +   +   +---+   +   +---+   +---+   +   +   +---+---+   +   +---+---+---+   +---+---+   +---+   +---+---+---+---+   +
|   |   |   |       |   |       |       |   |   |           |   |               |           |       |                   |
+   +   +---+---+   +   +---+---+---+---+---+   +   +---+   +   +   +---+   +   +---+---+   +---+---+   +   +   +---+   +
|   |   |           |   |                       |   |       |   |   |       |   |           |           |   |   |       |
+   +   +   +   +---+---+---+   +   +---+   +   +---+   +---+---+   +---+   +---+   +   +   +---+---+   +---+   +   +   +
|   |   |   |   |               |   |       |   |       |           |       |       |   |   |           |       |   |   |
+   +---+---+---+---+---+   +   +---+---+   +   +   +---+   +   +---+   +   +---+---+   +   +   +   +---+   +---+   +   +
|   |                       |   |           |   |   |       |   |       |   |           |   |   |   |       |       |   |
+---+---+   +   +   +   +   +---+   +   +---+---+   +---+   +---+---+   +   +---+   +---+---+---+   +---+   +   +   +   +
|           |   |   |   |   |       |   |           |       |           |   |       |               |       |   |   |   |
+   +   +---+   +   +---+   +---+   +---+   +   +---+---+   +---+   +---+---+---+---+   +---+---+   +---+   +---+   +   +
|   |   |       |   |       |       |       |   |           |       |                   |           |       |       |   |
+   +---+---+---+   +---+---+---+---+   +---+   +---+---+---+   +   +   +---+   +   +   +---+---+   +---+---+   +---+   +
|   |               |                   |       |               |   |   |       |   |   |           |           |       |
+---+   +---+   +---+---+---+---+   +---+   +---+---+---+   +---+---+   +   +   +---+   +---+   +---+---+   +   +---+   +
|       |       |                   |       |               |           |   |   |       |       |           |   |       |
+---+---+   +---+   +   +   +   +   +---+---+   +   +   +   +   +   +   +   +   +   +---+   +---+   +   +---+   +---+   +
|           |       |   |   |   |   |           |   |   |   |   |   |   |   |   |   |       |       |   |       |       |
+---+---+---+---+   +---+---+   +   +   +---+---+---+   +---+   +---+---+   +   +   +---+---+---+   +   +---+---+---+   +
|                   |           |   |   |               |       |           |   |   |               |   |               |
+   +---+   +---+---+---+   +   +   +---+---+   +   +---+   +   +---+   +---+   +---+---+---+---+   +---+   +   +---+   +
|   |       |               |   |   |           |   |       |   |       |       |                   |       |   |       |
+---+---+---+---+---+---+---+---+---+---+---+---+---+---+---+---+---+---+---+---+---+---+---+---+---+---+---+---+---+---+
